1,1,1,1,1,1,1,1,1,1,1,1,1,0,1,1,1,1,1,1,1,1,1,1,1,1,1,
1,1,1,1,1,1,1,1,1,1,1,1,1,0,1,1,1,1,1,1,1,1,1,1,1,1,1,
1,1,1,4,4,4,4,4,4,4,4,4,4,2,4,1,1,1,1,4,4,4,4,4,4,1,1,
1,1,1,4,1,1,1,1,4,1,1,1,4,4,4,4,4,4,4,4,1,1,1,1,4,1,1,
1,1,1,4,4,4,1,1,4,1,1,1,4,1,1,1,1,1,4,4,4,4,4,4,4,1,1,
1,1,1,1,1,4,1,1,4,1,1,1,4,4,4,4,4,4,4,1,1,4,5,1,4,1,1,
1,1,1,1,1,4,1,1,4,1,1,1,4,4,1,1,1,1,1,1,1,4,1,1,4,1,1,
1,1,1,1,1,4,5,4,4,4,4,4,4,4,4,4,4,4,4,4,1,4,1,1,4,1,1,
1,1,1,1,1,1,4,1,1,1,1,1,1,4,1,1,1,1,1,4,1,4,4,4,4,1,1,
1,1,1,1,1,1,4,4,4,1,1,1,1,4,4,4,4,4,4,4,1,1,4,1,4,1,1,
1,1,1,1,1,1,1,1,4,1,1,1,1,4,1,4,1,4,4,4,4,4,4,4,4,1,1,
1,1,1,1,1,1,1,1,4,1,1,1,1,4,4,4,4,4,1,1,1,1,4,1,4,1,1,
1,1,1,1,1,1,1,1,4,4,4,1,1,1,1,4,1,1,1,1,1,1,4,1,4,1,1,
1,1,1,1,1,1,1,1,4,1,4,4,4,4,4,4,1,1,1,1,1,1,4,4,4,1,1,
1,1,4,4,4,4,4,4,4,4,4,1,1,1,4,1,1,1,-8,0,-8,1,4,1,4,1,1,
1,1,4,1,1,1,1,1,1,1,4,1,1,4,4,1,1,1,0,-8,0,1,4,1,4,1,1,
1,1,4,1,1,1,1,1,1,1,4,1,1,4,1,1,1,1,1,0,1,1,4,1,4,1,1,
1,1,4,1,1,1,1,1,1,4,4,4,1,4,4,4,4,4,4,4,4,4,4,4,4,1,1,
1,1,4,1,1,1,4,4,4,4,1,4,1,1,1,1,1,4,1,1,4,1,1,1,4,1,1,
1,1,4,1,1,1,4,1,1,4,4,4,1,1,1,1,4,4,1,1,4,1,1,1,4,1,1,
1,1,4,4,4,4,5,1,1,4,1,4,1,1,1,4,4,4,4,4,4,4,5,4,4,1,1,
1,1,4,1,1,1,4,1,4,4,1,4,4,4,4,4,1,4,1,1,4,1,1,1,4,1,1,
1,1,4,1,1,1,4,4,4,1,1,1,1,1,4,1,1,4,1,1,4,1,1,1,4,1,1,
1,1,4,4,4,4,4,1,4,4,4,4,4,4,4,4,4,4,4,4,4,4,4,4,4,1,1,
1,1,1,1,1,1,1,1,1,1,1,1,1,0,1,1,1,1,1,1,1,1,1,1,1,1,1,
c8d4d3
7caed1